X  X 1 X X X 

X X   X  X
2
X X X    XX
X   XX  X   XX

X    X    X   X   X